222212222222221222222222122222
200000000220000000022000000002
200020000000002000000000200002
221220000222122000022212200002
200020000220002000022000200002
200000000120000000012000000001
221220000222122000022212200002
200020000220002000022000200002
200000000220000000022000000002
222221202222222120222222212022
222212202222221222222222122222
200000000220000000022000000002
200020000220002000022000200002
221220000222122000022212200002
200020000000002000022000200002
200000000120000000012000000001
221220000222122000022212200002
200020000220002000022000200002
200000000000000000022000000002
222221202222222120222222212022
