2222122222
2000000002
2000200002
2212200002
2000200002
2000000001
2212200002
2000200002
2000000002
2222212022
